0			0			2048			816			4			0			
0			0			1024			408			4			0			
0			0			512			204			4			0			
0			0			256			102			0			0			
256			0			256			102			0			0			
0			102			256			102			0			7			0		1		512		549		556		631		632		
256			102			256			102			0			27			2		3		4		5		6		7		8		9		10		11		12		13		14		15		16		17		588		589		607		608		609		610		622		633		634		635		636		
512			0			512			204			4			0			
512			0			256			102			0			8			31		32		33		34		49		50		51		52		
768			0			256			102			0			0			
512			102			256			102			0			37			18		19		20		21		22		23		24		25		26		27		28		29		30		34		35		36		37		38		39		40		41		44		45		46		47		48		49		605		606		618		619		637		638		639		640		641		642		
768			102			256			102			0			0			
0			204			512			204			4			0			
0			204			256			102			0			16			53		54		55		56		57		70		71		72		73		74		202		203		546		547		604		630		
256			204			256			102			0			20			204		205		206		207		208		209		210		211		212		213		214		215		216		217		218		219		545		550		553		555		
0			306			256			102			0			41			57		58		59		60		61		62		63		64		65		66		67		68		69		70		75		76		77		78		79		80		81		82		83		84		85		86		87		88		200		201		202		203		548		602		603		604		620		621		628		629		630		
256			306			256			102			0			33			89		90		91		92		93		94		95		96		97		98		99		100		101		102		103		104		105		106		107		108		551		553		554		555		599		600		601		623		624		625		626		627		643		
512			204			512			204			4			0			
512			204			256			102			0			29			41		42		43		44		220		221		222		223		224		225		226		227		228		229		230		231		232		233		234		235		241		242		243		244		614		615		616		617		618		
768			204			256			102			0			21			236		237		238		239		240		245		246		247		248		249		250		251		252		253		254		255		256		257		513		595		649		
512			306			256			102			0			44			109		110		111		112		113		114		115		116		117		118		119		120		121		122		123		124		125		126		127		128		129		130		131		132		133		143		144		145		146		147		148		151		152		153		154		155		156		552		596		597		598		644		645		646		
768			306			256			102			0			38			134		135		136		137		138		139		140		141		142		149		150		157		246		247		248		249		250		251		252		253		254		255		256		257		258		259		262		263		264		265		513		583		584		612		613		647		648		650		
1024			0			1024			408			4			0			
1024			0			512			204			0			0			
1536			0			512			204			0			0			
1024			204			512			204			4			0			
1024			204			256			102			0			10			266		267		268		269		561		562		593		594		651		654		
1280			204			256			102			0			30			270		271		272		273		274		275		276		277		278		279		280		281		282		283		284		285		298		299		300		301		302		543		544		557		590		591		592		656		657		660		
1024			306			256			102			0			24			260		261		266		267		268		269		317		318		319		320		321		322		323		324		325		326		542		561		562		585		586		652		653		655		
1280			306			256			102			0			42			270		271		272		273		275		276		277		278		279		280		281		286		287		288		289		290		291		292		293		294		295		296		297		298		303		304		305		306		307		308		309		310		311		312		313		314		315		316		327		328		658		659		
1536			204			512			204			0			0			
0			408			1024			408			4			0			
0			408			512			204			4			0			
0			408			256			102			0			2			63		64		
256			408			256			102			0			2			106		107		
0			510			256			102			0			0			
256			510			256			102			0			0			
512			408			512			204			4			0			
512			408			256			102			0			16			109		110		111		112		113		114		115		116		117		118		119		128		129		131		132		133		
768			408			256			102			0			39			134		135		158		159		160		161		162		175		176		177		178		179		180		181		182		183		184		185		186		187		188		189		190		191		192		193		194		195		541		563		564		565		566		567		611		612		661		662		663		
512			510			256			102			0			0			
768			510			256			102			0			28			162		163		164		165		166		167		168		169		170		171		172		173		174		175		182		183		184		185		186		187		188		189		190		191		192		193		194		195		
0			612			512			204			0			0			
512			612			512			204			0			0			
1024			408			1024			408			4			0			
1024			408			512			204			4			0			
1024			408			256			102			0			25			196		197		198		199		329		330		331		332		333		334		335		336		337		338		339		340		558		568		569		570		571		664		665		666		667		
1280			408			256			102			0			26			291		292		341		342		343		344		345		346		347		348		349		350		351		352		353		354		355		356		572		573		574		575		668		669		670		671		
1024			510			256			102			0			14			196		197		329		330		331		332		333		334		335		336		337		338		339		340		
1280			510			256			102			0			28			341		342		343		344		345		346		347		348		349		350		351		352		353		354		355		356		359		360		361		362		363		364		365		372		373		374		375		376		
1536			408			512			204			4			0			
1536			408			256			102			0			19			357		358		377		378		379		380		393		394		395		396		540		559		560		576		577		578		672		673		674		
1792			408			256			102			0			27			397		398		425		429		430		431		432		489		490		491		492		493		494		507		508		509		510		536		579		580		581		582		587		675		676		677		678		
1536			510			256			102			0			40			357		358		366		367		368		369		370		371		377		378		379		380		381		382		383		384		385		386		387		388		389		390		391		392		393		394		395		396		399		400		401		402		403		404		405		412		413		414		415		560		
1792			510			256			102			0			48			397		398		406		407		408		409		410		411		416		417		418		419		420		421		422		423		424		425		426		427		428		429		430		431		432		494		495		496		497		498		499		500		501		502		503		504		505		506		507		511		528		531		532		533		534		535		536		539		
1024			612			512			204			0			0			
1536			612			512			204			4			0			
1536			612			256			102			0			0			
1792			612			256			102			0			36			433		434		435		436		437		438		441		442		443		444		445		446		447		448		449		450		451		472		473		474		475		476		477		478		479		480		481		520		521		522		523		524		525		526		527		528		
1536			714			256			102			0			0			
1792			714			256			102			0			43			438		439		440		441		452		453		454		455		456		457		458		459		460		461		462		463		464		465		466		467		468		469		470		471		472		482		483		484		485		486		487		488		514		515		516		517		518		519		521		529		530		537		538		
