0			0			4096			1632			4			0			
0			0			2048			816			4			0			
0			0			1024			408			4			0			
0			0			512			204			4			0			
0			0			256			102			0			2			549		550		
256			0			256			102			0			0			
0			102			256			102			0			8			549		550		551		552		553		555		556		557		
256			102			256			102			0			0			
512			0			512			204			0			0			
0			204			512			204			4			0			
0			204			256			102			0			6			1		553		554		555		558		573		
256			204			256			102			0			2			2		698		
0			306			256			102			0			10			1		559		560		561		562		563		564		565		566		573		
256			306			256			102			0			8			567		568		569		570		571		572		574		575		
512			204			512			204			4			0			
512			204			256			102			0			5			3		4		11		699		700		
768			204			256			102			0			6			0		5		6		10		701		702		
512			306			256			102			0			8			576		577		578		579		580		581		582		583		
768			306			256			102			0			9			0		584		585		586		587		588		589		590		591		
1024			0			1024			408			4			0			
1024			0			512			204			4			0			
1024			0			256			102			0			0			
1280			0			256			102			0			2			604		605		
1024			102			256			102			0			0			
1280			102			256			102			0			8			604		605		606		607		608		623		624		625		
1536			0			512			204			0			0			
1024			204			512			204			4			0			
1024			204			256			102			0			4			7		8		703		704		
1280			204			256			102			0			12			9		27		608		609		610		611		620		621		622		623		705		706		
1024			306			256			102			0			8			592		593		594		595		596		597		598		599		
1280			306			256			102			0			15			600		601		602		603		611		612		613		614		617		618		619		620		626		645		646		
1536			204			512			204			0			0			
0			408			1024			408			4			0			
0			408			512			204			4			0			
0			408			256			102			0			2			524		525		
256			408			256			102			0			0			
0			510			256			102			0			12			14		524		525		526		527		528		529		536		537		538		539		696		
256			510			256			102			0			4			13		24		496		497		
512			408			512			204			4			0			
512			408			256			102			0			1			12		
768			408			256			102			0			0			
512			510			256			102			0			10			12		13		498		499		500		501		502		503		504		505		
768			510			256			102			0			11			506		507		508		509		510		511		512		513		689		690		691		
0			612			512			204			4			0			
0			612			256			102			0			10			14		529		530		531		532		539		540		541		542		696		
256			612			256			102			0			12			15		16		17		495		496		497		546		547		548		692		693		697		
0			714			256			102			0			14			488		489		490		491		492		493		532		533		534		535		542		543		544		545		
256			714			256			102			0			10			480		481		482		483		484		485		486		487		495		546		
512			612			512			204			4			0			
512			612			256			102			0			4			18		19		688		694		
768			612			256			102			0			6			20		21		687		689		690		695		
512			714			256			102			0			9			472		473		474		475		476		477		478		479		494		
768			714			256			102			0			12			460		461		462		463		464		465		466		467		468		469		470		471		
1024			408			1024			408			4			0			
1024			408			512			204			4			0			
1024			408			256			102			0			0			
1280			408			256			102			0			10			614		615		616		617		627		628		644		645		647		648		
1024			510			256			102			0			8			514		515		516		517		518		519		520		521		
1280			510			256			102			0			14			522		523		627		628		635		636		637		638		639		640		641		642		643		647		
1536			408			512			204			4			0			
1536			408			256			102			0			2			629		630		
1792			408			256			102			0			2			29		678		
1536			510			256			102			0			11			406		407		408		409		629		630		631		632		633		634		649		
1792			510			256			102			0			10			29		398		399		400		401		402		403		404		405		678		
1024			612			512			204			4			0			
1024			612			256			102			0			4			22		23		685		686		
1280			612			256			102			0			13			25		26		414		415		416		417		418		419		440		441		442		449		684		
1024			714			256			102			0			8			452		453		454		455		456		457		458		459		
1280			714			256			102			0			26			417		418		419		428		429		430		431		432		433		434		435		436		437		438		439		440		441		442		443		444		445		446		447		448		450		451		
1536			612			512			204			4			0			
1536			612			256			102			0			13			28		406		407		408		409		410		411		412		413		420		421		649		674		
1792			612			256			102			0			11			30		35		398		399		400		401		402		403		404		405		675		
1536			714			256			102			0			12			326		327		328		329		420		421		422		423		424		425		426		427		
1792			714			256			102			0			5			35		330		331		332		333		
2048			0			2048			816			4			0			
2048			0			1024			408			0			0			
3072			0			1024			408			0			0			
2048			408			1024			408			4			0			
2048			408			512			204			4			0			
2048			408			256			102			0			2			31		677		
2304			408			256			102			0			2			32		679		
2048			510			256			102			0			5			31		38		396		397		677		
2304			510			256			102			0			5			32		39		394		395		679		
2560			408			512			204			4			0			
2560			408			256			102			0			3			40		41		681		
2816			408			256			102			0			4			43		340		361		680		
2560			510			256			102			0			11			40		41		45		47		390		391		392		393		681		682		707		
2816			510			256			102			0			20			43		44		47		340		341		342		343		344		357		358		359		360		361		362		363		364		365		366		367		680		
2048			612			512			204			4			0			
2048			612			256			102			0			6			34		36		38		396		397		676		
2304			612			256			102			0			5			33		39		46		394		395		
2048			714			256			102			0			7			37		334		335		336		337		338		339		
2304			714			256			102			0			7			46		370		371		372		373		374		375		
2560			612			512			204			4			0			
2560			612			256			102			0			6			368		369		390		391		392		393		
2816			612			256			102			0			15			42		344		345		346		347		354		355		356		357		362		363		364		365		366		367		
2560			714			256			102			0			8			376		377		378		379		380		381		382		383		
2816			714			256			102			0			14			347		348		349		350		351		352		353		354		384		385		386		387		388		389		
3072			408			1024			408			0			0			
0			816			2048			816			4			0			
0			816			1024			408			4			0			
0			816			512			204			4			0			
0			816			256			102			0			2			535		545		
256			816			256			102			0			0			
0			918			256			102			0			0			
256			918			256			102			0			0			
512			816			512			204			4			0			
512			816			256			102			0			0			
768			816			256			102			0			2			460		461		
512			918			256			102			0			0			
768			918			256			102			0			0			
0			1020			512			204			0			0			
512			1020			512			204			0			0			
1024			816			1024			408			4			0			
1024			816			512			204			4			0			
1024			816			256			102			0			8			452		453		454		455		456		457		458		459		
1280			816			256			102			0			8			430		431		436		437		445		446		450		451		
1024			918			256			102			0			0			
1280			918			256			102			0			0			
1536			816			512			204			4			0			
1536			816			256			102			0			12			48		49		303		304		323		324		325		326		424		425		671		683		
1792			816			256			102			0			2			51		672		
1536			918			256			102			0			17			295		296		297		298		299		300		301		302		304		305		306		307		320		321		322		323		325		
1792			918			256			102			0			11			50		57		287		288		289		290		291		292		293		294		673		
1024			1020			512			204			0			0			
1536			1020			512			204			4			0			
1536			1020			256			102			0			16			295		296		297		298		299		300		307		308		309		310		311		316		317		318		319		320		
1792			1020			256			102			0			8			287		288		289		290		291		292		293		294		
1536			1122			256			102			0			6			311		312		313		314		315		316		
1792			1122			256			102			0			0			
0			1224			1024			408			0			0			
1024			1224			1024			408			0			0			
2048			816			2048			816			4			0			
2048			816			1024			408			4			0			
2048			816			512			204			4			0			
2048			816			256			102			0			2			53		669		
2304			816			256			102			0			4			54		55		667		668		
2048			918			256			102			0			10			52		279		280		281		282		283		284		285		286		670		
2304			918			256			102			0			9			56		271		272		273		274		275		276		277		278		
2560			816			512			204			4			0			
2560			816			256			102			0			5			58		59		67		665		666		
2816			816			256			102			0			6			60		61		350		351		663		664		
2560			918			256			102			0			9			67		263		264		265		266		267		268		269		270		
2816			918			256			102			0			8			248		249		257		258		259		260		261		262		
2048			1020			512			204			4			0			
2048			1020			256			102			0			6			279		280		281		282		285		286		
2304			1020			256			102			0			8			271		272		273		274		275		276		277		278		
2048			1122			256			102			0			0			
2304			1122			256			102			0			0			
2560			1020			512			204			4			0			
2560			1020			256			102			0			8			263		264		265		266		267		268		269		270		
2816			1020			256			102			0			16			244		245		246		247		248		249		250		251		252		253		257		258		259		260		261		262		
2560			1122			256			102			0			0			
2816			1122			256			102			0			6			242		243		244		253		254		255		
3072			816			1024			408			4			0			
3072			816			512			204			4			0			
3072			816			256			102			0			4			62		234		256		662		
3328			816			256			102			0			4			63		64		660		661		
3072			918			256			102			0			6			66		215		216		234		235		651		
3328			918			256			102			0			7			190		191		192		193		217		218		651		
3584			816			512			204			4			0			
3584			816			256			102			0			5			65		68		214		658		659		
3840			816			256			102			0			8			69		70		150		151		152		169		656		657		
3584			918			256			102			0			5			71		172		173		194		195		
3840			918			256			102			0			12			152		153		154		155		166		167		168		169		174		175		176		177		
3072			1020			512			204			4			0			
3072			1020			256			102			0			10			66		215		216		231		232		235		236		237		238		239		
3328			1020			256			102			0			22			190		191		192		193		196		197		198		199		204		205		206		207		217		218		219		220		221		222		227		228		229		230		
3072			1122			256			102			0			3			239		240		241		
3328			1122			256			102			0			12			199		200		201		202		203		204		222		223		224		225		226		227		
3584			1020			512			204			4			0			
3584			1020			256			102			0			22			71		172		173		178		179		180		181		182		183		184		185		186		187		188		189		194		195		208		209		210		211		655		
3840			1020			256			102			0			18			147		148		149		155		156		157		158		162		163		164		165		166		170		171		174		175		176		177		
3584			1122			256			102			0			8			181		182		188		189		211		212		213		650		
3840			1122			256			102			0			10			145		146		147		158		159		160		161		162		233		650		
2048			1224			1024			408			0			0			
3072			1224			1024			408			4			0			
3072			1224			512			204			0			0			
3584			1224			512			204			4			0			
3584			1224			256			102			0			7			77		119		120		121		143		144		650		
3840			1224			256			102			0			11			78		79		80		104		105		106		108		109		110		650		654		
3584			1326			256			102			0			15			121		122		123		124		127		128		129		130		131		132		133		134		135		142		143		
3840			1326			256			102			0			11			80		82		83		106		107		110		111		112		113		136		137		
3072			1428			512			204			0			0			
3584			1428			512			204			4			0			
3584			1428			256			102			0			7			76		81		124		125		126		127		652		
3840			1428			256			102			0			16			73		74		75		83		84		101		102		103		113		114		115		116		139		140		141		653		
3584			1530			256			102			0			10			81		85		86		87		88		89		90		91		92		138		
3840			1530			256			102			0			14			72		93		94		95		96		97		98		99		100		101		116		117		118		139		
