95
51
128
0 0 0 0 0 0 0 0 0 0 0 0 0 0 0 0 0 0 0 0 0 0 0 0 0 0 0 0 0 0 0 0 0 0 0 0 0 0 0 0 0 0 0 0 0 0 0 0 0 0 0 0 0 0 0 0 0 0 0 0 0 0 0 0 0 0 0 0 0 0 0 0 0 0 0 0 0 0 0 0 0 0 0 0 0 0 0 0 0 0 0 0 0 0 0 0 0 0 0 0 0 0 0 0 0 0 0 0 0 0 0 0 0 0 0 0 0 0 0 0 0 0 0 0 0 0 0 0 
0 0 0 0 0 0 0 0 0 0 0 0 0 0 0 0 0 0 0 0 0 0 0 0 0 0 0 0 0 0 0 0 0 0 0 0 0 0 0 0 0 0 0 0 0 0 0 0 0 0 0 0 0 0 0 0 0 0 0 0 0 0 0 0 0 0 0 0 0 0 0 0 0 0 0 0 0 0 0 0 0 0 0 0 0 0 0 0 0 0 0 0 0 0 0 0 0 0 0 0 0 0 0 0 0 0 0 0 0 0 0 0 0 0 0 0 0 0 0 0 0 0 0 0 0 0 0 0 
0 0 0 0 0 0 0 0 0 0 0 0 0 0 0 0 0 0 0 0 0 0 0 0 0 0 0 0 0 0 0 0 0 0 0 0 0 0 0 0 0 0 0 0 0 0 0 0 0 0 0 0 0 0 0 0 0 0 0 0 0 0 0 0 0 0 0 0 0 0 0 0 0 0 0 0 0 0 0 0 0 0 0 0 0 0 0 0 0 0 0 0 0 0 0 0 0 0 0 0 0 0 0 0 0 0 0 0 0 0 0 0 0 0 0 0 0 0 0 0 0 0 0 0 0 0 0 0 
1 1 0 0 0 0 2 3 0 0 0 0 4 5 6 7 6 7 6 7 6 7 6 7 6 7 6 7 6 7 6 7 6 7 6 7 6 7 6 7 6 7 6 7 6 7 1 1 0 0 0 0 0 0 0 0 0 0 0 0 0 0 0 0 0 0 0 0 0 0 0 0 0 0 0 0 0 0 0 0 0 0 0 0 0 0 0 0 0 0 0 0 0 0 0 0 0 0 0 0 0 0 0 0 0 0 0 0 0 0 0 0 0 0 0 0 0 0 0 0 0 0 0 0 0 0 0 0 
1 1 0 0 0 0 8 8 0 0 0 0 9 5 10 11 10 11 12 13 14 15 12 16 17 18 12 16 17 18 12 16 17 18 12 16 17 18 12 16 17 18 12 16 19 20 1 1 0 0 0 0 0 0 0 0 0 0 0 0 0 0 0 0 0 0 0 0 0 0 0 0 0 0 0 0 0 0 0 0 0 0 0 0 0 0 0 0 0 0 0 0 0 0 0 0 0 0 0 0 0 0 0 0 0 0 0 0 0 0 0 0 0 0 0 0 0 0 0 0 0 0 0 0 0 0 0 0 
1 1 0 0 21 22 8 8 21 22 0 0 9 5 6 7 6 7 0 0 4 5 0 0 4 5 0 0 4 5 0 0 4 5 0 0 4 5 0 0 4 5 0 0 20 20 1 1 0 0 0 0 0 0 0 0 0 0 0 0 0 0 0 0 0 0 0 0 0 0 0 0 0 0 0 0 0 0 0 0 0 0 0 0 0 0 0 0 0 0 0 0 0 0 0 0 0 0 0 0 0 0 0 0 0 0 0 0 0 0 0 0 0 0 0 0 0 0 0 0 0 0 0 0 0 0 0 0 
1 1 0 0 23 24 8 8 23 24 0 0 9 5 20 20 20 20 25 26 9 5 25 26 9 5 25 26 9 5 25 26 9 5 25 26 9 5 25 26 9 5 25 26 20 20 1 1 0 0 0 0 0 0 0 0 0 0 0 0 0 0 0 0 0 0 0 0 0 0 0 0 0 0 0 0 0 0 0 0 0 0 0 0 0 0 0 0 0 0 0 0 0 0 0 0 0 0 0 0 0 0 0 0 0 0 0 0 0 0 0 0 0 0 0 0 0 0 0 0 0 0 0 0 0 0 0 0 
1 1 21 22 23 24 8 8 23 24 21 22 9 5 20 20 20 20 27 28 9 5 27 28 9 5 27 28 9 5 27 28 9 5 27 28 9 5 27 28 9 5 27 28 20 20 1 1 0 0 0 0 0 0 0 0 0 0 0 0 0 0 0 0 0 0 0 0 0 0 0 0 0 0 0 0 0 0 0 0 0 0 0 0 0 0 0 0 0 0 0 0 0 0 0 0 0 0 0 0 0 0 0 0 0 0 0 0 0 0 0 0 0 0 0 0 0 0 0 0 0 0 0 0 0 0 0 0 
29 30 23 24 23 24 31 32 23 24 23 24 9 5 20 20 20 20 33 28 9 5 33 28 9 5 33 28 9 5 33 28 9 5 33 28 9 5 33 28 9 5 33 28 20 20 1 1 0 0 0 0 0 0 0 0 0 0 0 0 0 0 0 0 0 0 0 0 0 0 0 0 0 0 0 0 0 0 0 0 0 0 0 0 0 0 0 0 0 0 0 0 0 0 0 0 0 0 0 0 0 0 0 0 0 0 0 0 0 0 0 0 0 0 0 0 0 0 0 0 0 0 0 0 0 0 0 0 
34 35 23 24 23 24 36 37 23 24 23 24 9 5 20 20 20 20 27 28 38 39 27 28 38 39 27 28 38 39 27 28 38 39 27 28 38 39 27 28 38 39 27 28 20 20 1 1 0 0 0 0 0 0 0 0 0 0 0 0 0 0 0 0 0 0 0 0 0 0 0 0 0 0 0 0 0 0 0 0 0 0 0 0 0 0 0 0 0 0 0 0 0 0 0 0 0 0 0 0 0 0 0 0 0 0 0 0 0 0 0 0 0 0 0 0 0 0 0 0 0 0 0 0 0 0 0 0 
40 41 42 43 42 43 44 45 42 43 42 43 38 39 1 1 1 1 1 1 1 1 1 1 1 1 1 1 1 1 1 1 1 1 1 1 1 1 1 1 1 1 1 1 20 20 1 1 0 0 0 0 0 0 0 0 0 0 0 0 0 0 0 0 0 0 0 0 0 0 0 0 0 0 0 0 0 0 0 0 0 0 0 0 0 0 0 0 0 0 0 0 0 0 0 0 0 0 0 0 0 0 0 0 0 0 0 0 0 0 0 0 0 0 0 0 0 0 0 0 0 0 0 0 0 0 0 0 
1 1 1 1 1 1 1 1 1 1 1 1 1 1 20 20 20 20 20 20 20 20 20 20 20 20 20 20 20 20 20 20 20 20 20 20 20 20 20 20 20 20 20 20 46 1 1 1 0 0 0 0 0 0 0 0 0 0 0 0 0 0 0 0 0 0 0 0 0 0 0 0 0 0 0 0 0 0 0 0 0 0 0 0 0 0 0 0 0 0 0 0 0 0 0 0 0 0 0 0 0 0 0 0 0 0 0 0 0 0 0 0 0 0 0 0 0 0 0 0 0 0 0 0 0 0 0 0 
10 11 10 11 10 11 10 11 10 11 10 11 10 11 10 11 10 11 12 16 17 18 12 16 17 18 12 16 17 18 12 16 17 18 12 16 17 18 12 16 17 47 48 49 20 20 1 1 0 0 0 0 0 0 0 0 0 0 0 0 0 0 0 0 0 0 0 0 0 0 0 0 0 0 0 0 0 0 0 0 0 0 0 0 0 0 0 0 0 0 0 0 0 0 0 0 0 0 0 0 0 0 0 0 0 0 0 0 0 0 0 0 0 0 0 0 0 0 0 0 0 0 0 0 0 0 0 0 
6 7 6 7 6 7 6 7 6 7 6 7 6 7 6 7 6 7 0 0 50 39 0 0 50 39 0 0 50 39 0 0 50 39 0 0 50 39 0 0 50 39 49 20 20 20 1 1 0 0 0 0 0 0 0 0 0 0 0 0 0 0 0 0 0 0 0 0 0 0 0 0 0 0 0 0 0 0 0 0 0 0 0 0 0 0 0 0 0 0 0 0 0 0 0 0 0 0 0 0 0 0 0 0 0 0 0 0 0 0 0 0 0 0 0 0 0 0 0 0 0 0 0 0 0 0 0 0 
0 0 0 0 0 0 0 0 0 0 0 0 0 0 0 0 0 0 0 0 0 0 0 0 0 0 0 0 0 0 0 0 0 0 0 0 0 0 0 0 0 0 0 0 0 0 0 0 0 0 0 0 0 0 0 0 0 0 0 0 0 0 0 0 0 0 0 0 0 0 0 0 0 0 0 0 0 0 0 0 0 0 0 0 0 0 0 0 0 0 0 0 0 0 0 0 0 0 0 0 0 0 0 0 0 0 0 0 0 0 0 0 0 0 0 0 0 0 0 0 0 0 0 0 0 0 0 0 
1 1 6 7 6 7 6 7 6 7 6 7 6 7 6 7 20 20 0 0 4 5 0 0 4 5 0 0 4 5 0 0 4 5 0 0 4 5 0 0 20 20 51 20 20 20 1 1 1 1 4 5 52 53 4 5 20 20 4 5 52 53 4 5 54 55 20 20 20 20 56 57 20 20 4 5 52 53 4 5 20 20 4 5 20 20 4 5 20 20 4 5 52 53 1 1 0 0 0 0 0 0 0 0 0 0 0 0 0 0 0 0 0 0 0 0 0 0 0 0 0 0 0 0 0 0 0 0 
1 58 59 16 17 18 12 16 17 18 12 16 17 18 12 13 54 55 0 0 38 39 0 0 38 39 0 0 38 39 0 0 38 39 0 0 38 39 0 0 60 49 61 55 62 63 1 1 1 1 9 5 20 20 9 5 64 65 9 5 20 20 9 5 66 67 20 20 20 20 20 20 64 65 9 5 66 68 9 5 20 20 9 5 20 20 38 39 64 65 9 5 69 30 1 1 0 0 0 0 0 0 0 0 0 0 0 0 0 0 0 0 0 0 0 0 0 0 0 0 0 0 0 0 0 0 0 0 
1 1 0 0 4 5 0 0 4 5 0 0 4 5 0 0 1 1 1 1 1 1 1 1 1 1 1 1 1 1 1 1 1 1 1 1 1 1 1 1 1 1 1 1 1 1 1 1 1 1 9 5 20 20 9 5 52 53 9 5 20 20 9 5 56 57 70 20 20 20 20 20 52 53 9 5 56 57 9 5 20 20 9 5 20 20 1 1 52 53 9 5 54 55 1 1 0 0 0 0 0 0 0 0 0 0 0 0 0 0 0 0 0 0 0 0 0 0 0 0 0 0 0 0 0 0 0 0 
1 1 42 42 9 5 42 42 9 5 42 42 9 5 0 0 20 20 12 16 17 18 71 72 17 18 71 72 17 18 71 72 17 18 12 16 17 18 12 13 4 5 20 20 20 20 66 68 29 30 9 5 62 63 38 39 62 63 38 39 62 63 38 39 20 20 20 20 64 65 62 63 20 20 9 5 69 30 38 39 62 63 38 39 64 65 4 5 62 63 38 39 54 55 1 1 0 0 0 0 0 0 0 0 0 0 0 0 0 0 0 0 0 0 0 0 0 0 0 0 0 0 0 0 0 0 0 0 
1 1 42 42 9 5 42 42 9 5 42 42 38 39 1 1 20 20 0 0 4 5 73 74 4 5 75 76 4 5 75 76 4 5 0 0 4 5 0 0 9 5 20 20 20 20 56 57 34 35 9 5 1 1 1 1 1 1 1 1 1 1 1 1 20 20 20 20 52 53 1 1 20 20 9 5 54 55 1 1 1 1 1 1 52 53 9 5 1 1 1 1 1 1 1 1 0 0 0 0 0 0 0 0 0 0 0 0 0 0 0 0 0 0 0 0 0 0 0 0 0 0 0 0 0 0 0 0 
1 1 42 42 9 5 42 42 9 5 77 78 1 1 20 20 69 30 0 0 9 5 75 76 9 5 0 0 9 5 0 0 9 5 42 42 9 5 42 42 9 5 20 20 54 55 62 63 40 41 38 39 66 68 79 18 12 16 17 18 12 16 17 47 19 20 20 20 20 20 79 47 80 30 81 15 12 16 17 18 12 13 4 5 54 55 81 15 12 16 17 18 12 13 1 1 0 0 0 0 0 0 0 0 0 0 0 0 0 0 0 0 0 0 0 0 0 0 0 0 0 0 0 0 0 0 0 0 
1 1 42 42 9 5 42 42 38 39 82 20 20 20 20 20 54 55 0 0 9 5 0 0 9 5 0 0 9 5 0 0 9 5 42 42 9 5 42 42 9 5 20 20 1 1 1 1 1 1 1 1 56 57 4 5 0 0 4 5 0 0 4 5 20 20 20 20 20 20 4 5 54 55 4 5 0 0 4 5 0 0 9 5 1 1 4 5 0 0 4 5 0 0 1 1 0 0 0 0 0 0 0 0 0 0 0 0 0 0 0 0 0 0 0 0 0 0 0 0 0 0 0 0 0 0 0 0 
1 1 42 43 38 39 42 43 1 1 61 55 62 63 62 63 54 55 0 0 38 39 0 0 38 39 0 0 38 39 0 0 9 5 42 42 9 5 42 42 9 5 1 1 1 1 1 1 1 1 14 83 64 65 9 5 20 20 9 5 20 20 38 39 54 55 64 65 62 63 38 39 84 85 38 39 54 55 38 39 62 63 38 39 62 63 38 39 62 63 38 39 62 63 1 1 0 0 0 0 0 0 0 0 0 0 0 0 0 0 0 0 0 0 0 0 0 0 0 0 0 0 0 0 0 0 0 0 
1 1 1 1 1 1 1 1 1 1 1 1 1 1 1 1 1 1 1 1 1 1 1 1 1 1 1 1 1 1 1 1 9 5 42 42 9 5 42 42 9 5 1 1 1 1 1 1 1 1 4 5 52 53 38 39 20 20 38 39 20 20 1 1 1 1 52 53 1 1 1 1 86 87 1 1 1 1 1 1 1 1 1 1 1 1 1 1 1 1 1 1 1 1 1 1 0 0 0 0 0 0 0 0 0 0 0 0 0 0 0 0 0 0 0 0 0 0 0 0 0 0 0 0 0 0 0 0 
1 1 10 11 10 11 10 11 10 11 10 11 10 11 10 11 10 11 10 11 10 11 10 11 10 11 10 11 10 11 1 1 38 39 42 43 38 39 42 43 38 39 1 1 1 1 1 1 1 1 9 5 60 49 1 1 66 68 1 58 59 16 17 18 12 13 0 0 12 16 17 18 0 0 79 18 12 16 17 18 12 16 17 18 12 16 17 18 12 16 17 18 12 13 1 1 0 0 0 0 0 0 0 0 0 0 0 0 0 0 0 0 0 0 0 0 0 0 0 0 0 0 0 0 0 0 0 0 
1 1 6 7 6 7 6 7 6 7 6 7 6 7 6 7 6 7 6 7 6 7 6 7 6 7 6 7 6 7 1 1 1 1 1 1 1 1 1 1 1 1 1 1 1 1 1 1 1 1 38 39 49 20 14 88 89 57 14 90 0 0 50 39 0 0 0 0 0 0 50 39 0 0 50 39 0 0 50 39 0 0 50 39 0 0 50 39 0 0 50 39 0 0 1 1 0 0 0 0 0 0 0 0 0 0 0 0 0 0 0 0 0 0 0 0 0 0 0 0 0 0 0 0 0 0 0 0 
0 0 0 0 0 0 0 0 0 0 0 0 0 0 0 0 0 0 0 0 0 0 0 0 0 0 0 0 0 0 0 0 0 0 0 0 0 0 0 0 0 0 0 0 0 0 0 0 0 0 0 0 0 0 0 0 0 0 0 0 0 0 0 0 0 0 0 0 0 0 0 0 0 0 0 0 0 0 0 0 0 0 0 0 0 0 0 0 0 0 0 0 0 0 0 0 0 0 0 0 0 0 0 0 0 0 0 0 0 0 0 0 0 0 0 0 0 0 0 0 0 0 0 0 0 0 0 0 
0 0 0 0 0 0 0 0 0 0 0 0 0 0 0 0 0 0 0 0 0 0 0 0 0 0 0 0 0 0 0 0 0 0 0 0 0 0 0 0 0 0 0 0 0 0 0 0 1 1 4 5 49 20 4 5 20 20 4 5 20 20 4 5 20 20 4 5 20 20 20 20 20 20 4 5 52 53 4 5 20 20 4 5 20 20 4 5 20 20 4 5 20 20 4 5 1 20 52 53 56 57 4 5 20 20 56 57 52 53 20 20 4 5 20 20 52 53 4 5 20 20 20 20 52 53 1 1 
0 0 0 0 0 0 0 0 0 0 0 0 0 0 0 0 0 0 0 0 0 0 0 0 0 0 0 0 0 0 0 0 0 0 0 0 0 0 0 0 0 0 0 0 0 0 0 0 1 1 38 91 20 20 9 5 20 20 9 5 69 30 9 5 20 20 38 39 20 20 20 20 64 65 9 5 20 20 9 5 20 20 9 5 20 20 9 5 20 20 9 5 20 20 9 5 29 30 66 67 20 20 9 5 69 30 64 65 20 20 20 20 9 5 64 65 20 20 9 5 69 30 64 65 20 20 1 1 
0 0 0 0 0 0 0 0 0 0 0 0 0 0 0 0 0 0 0 0 0 0 0 0 0 0 0 0 0 0 0 0 0 0 0 0 0 0 0 0 0 0 0 0 0 0 0 0 1 1 1 1 20 20 9 5 20 20 9 5 54 55 9 5 20 20 1 1 20 20 20 20 52 53 9 5 20 20 9 5 20 20 9 5 20 20 9 5 20 20 9 5 20 20 9 5 34 35 56 57 70 20 9 5 54 55 52 53 20 20 20 20 9 5 52 53 20 20 9 5 54 55 52 53 20 20 1 1 
0 0 0 0 0 0 0 0 0 0 0 0 0 0 0 0 0 0 0 0 0 0 0 0 0 0 0 0 0 0 0 0 0 0 0 0 0 0 0 0 0 0 0 0 0 0 0 0 1 1 50 39 62 63 38 39 62 63 38 39 54 55 38 39 62 63 4 5 62 63 54 55 54 55 38 39 62 63 38 39 62 63 38 39 54 55 38 39 54 55 38 39 62 63 38 39 40 41 20 20 64 65 38 39 54 55 20 20 62 63 62 63 38 39 66 67 20 20 38 39 54 55 62 63 20 20 1 1 
0 0 0 0 0 0 0 0 0 0 0 0 0 0 0 0 0 0 0 0 0 0 0 0 0 0 0 0 0 0 0 0 0 0 0 0 0 0 0 0 0 0 0 0 0 0 0 0 1 1 1 1 1 1 1 1 1 1 1 1 1 1 1 1 1 1 38 5 1 1 1 1 1 1 1 1 1 1 1 1 1 1 1 1 1 1 1 1 1 1 1 1 1 1 1 1 1 1 20 20 52 53 1 1 1 1 20 20 1 1 1 1 1 1 56 57 70 20 1 1 1 1 1 1 20 20 1 1 
0 0 0 0 0 0 0 0 0 0 0 0 0 0 0 0 0 0 0 0 0 0 0 0 0 0 0 0 0 0 0 0 0 0 0 0 0 0 0 0 0 0 0 0 0 0 0 0 1 1 4 5 12 16 17 18 12 16 17 18 12 16 17 18 12 16 17 18 12 16 17 18 12 16 17 18 12 16 17 18 12 16 17 18 12 16 17 18 12 16 17 18 12 13 1 1 1 20 20 20 54 55 4 5 1 1 20 20 20 20 1 1 1 20 62 63 69 30 1 1 66 68 69 30 20 20 1 1 
0 0 0 0 0 0 0 0 0 0 0 0 0 0 0 0 0 0 0 0 0 0 0 0 0 0 0 0 0 0 0 0 0 0 0 0 0 0 0 0 0 0 0 0 0 0 0 0 1 1 9 5 0 0 4 5 0 0 4 5 0 0 4 5 0 0 4 5 0 0 4 5 0 0 4 5 0 0 4 5 0 0 4 5 0 0 4 5 0 0 4 5 0 0 1 1 1 20 20 20 1 1 9 5 1 1 20 20 20 20 1 1 1 20 1 1 54 55 1 1 56 57 54 55 92 1 1 1 
0 0 0 0 0 0 0 0 0 0 0 0 0 0 0 0 0 0 0 0 0 0 0 0 0 0 0 0 0 0 0 0 0 0 0 0 0 0 0 0 0 0 0 0 0 0 0 0 1 1 9 5 64 65 9 5 64 65 9 5 64 65 9 5 64 65 9 5 64 65 9 5 64 65 9 5 64 65 9 5 64 65 9 5 64 65 9 5 64 65 9 5 64 65 1 1 1 20 64 65 66 68 9 5 1 1 20 20 64 65 1 1 1 20 20 20 54 55 1 1 20 20 60 49 93 5 1 1 
0 0 0 0 0 0 0 0 0 0 0 0 0 0 0 0 0 0 0 0 0 0 0 0 0 0 0 0 0 0 0 0 0 0 0 0 0 0 0 0 0 0 0 0 0 0 0 0 1 1 9 5 52 53 9 5 52 53 9 5 52 53 9 5 52 53 9 5 52 53 9 5 52 53 9 5 52 53 9 5 52 53 9 5 52 53 9 5 52 53 9 5 52 53 1 1 1 20 52 53 56 57 9 5 1 1 20 20 52 53 1 1 1 20 20 20 1 1 1 1 20 20 49 20 9 5 1 1 
0 0 0 0 0 0 0 0 0 0 0 0 0 0 0 0 0 0 0 0 0 0 0 0 0 0 0 0 0 0 0 0 0 0 0 0 0 0 0 0 0 0 0 0 0 0 0 0 1 1 9 5 66 68 9 5 20 20 9 5 66 68 9 5 66 68 9 5 69 30 9 5 20 20 9 5 66 68 9 5 20 20 9 5 66 68 9 5 20 20 9 5 66 68 1 1 1 20 69 30 20 20 9 5 1 1 20 20 20 20 1 1 1 20 20 20 20 20 20 20 60 49 20 20 9 5 1 1 
0 0 0 0 0 0 0 0 0 0 0 0 0 0 0 0 0 0 0 0 0 0 0 0 0 0 0 0 0 0 0 0 0 0 0 0 0 0 0 0 0 0 0 0 0 0 0 0 1 1 38 39 94 57 38 39 20 20 38 39 94 57 38 39 94 57 38 39 54 55 38 39 20 20 38 39 94 57 38 39 20 20 38 39 94 57 38 39 20 20 38 39 94 57 1 1 1 20 54 55 20 20 38 39 1 1 20 20 20 20 1 1 1 20 20 20 20 20 20 20 49 20 20 20 38 39 1 1 
0 0 0 0 0 0 0 0 0 0 0 0 0 0 0 0 0 0 0 0 0 0 0 0 0 0 0 0 0 0 0 0 0 0 0 0 0 0 0 0 0 0 0 0 0 0 0 0 0 0 0 0 0 0 0 0 0 0 0 0 0 0 0 0 0 0 0 0 0 0 0 0 0 0 0 0 0 0 0 0 0 0 0 0 0 0 0 0 0 0 0 0 0 0 0 0 0 0 0 0 0 0 0 0 0 0 0 0 0 0 0 0 0 0 0 0 0 0 0 0 0 0 0 0 0 0 0 0 
0 0 0 0 0 0 0 0 0 0 0 0 0 0 0 0 0 0 0 0 0 0 0 0 0 0 0 0 0 0 0 0 0 0 0 0 0 0 0 0 0 0 0 0 0 0 0 0 0 0 0 0 0 0 0 0 0 0 0 0 0 0 0 0 0 0 0 0 0 0 0 0 0 0 0 0 0 0 0 0 0 0 0 0 0 0 0 0 0 0 0 0 0 0 0 0 0 0 0 0 0 0 0 0 0 0 0 0 0 0 0 0 1 20 4 5 20 20 20 20 49 20 54 55 4 5 1 1 
0 0 0 0 0 0 0 0 0 0 0 0 0 0 0 0 0 0 0 0 0 0 0 0 0 0 0 0 0 0 0 0 0 0 0 0 0 0 0 0 0 0 0 0 0 0 0 0 0 0 0 0 0 0 0 0 0 0 0 0 0 0 0 0 0 0 0 0 0 0 0 0 0 0 0 0 0 0 0 0 0 0 0 0 0 0 0 0 0 0 0 0 0 0 0 0 0 0 0 0 0 0 0 0 0 0 0 0 0 0 0 0 1 20 9 5 20 20 60 49 20 20 66 68 9 5 1 1 
0 0 0 0 0 0 0 0 0 0 0 0 0 0 0 0 0 0 0 0 0 0 0 0 0 0 0 0 0 0 0 0 0 0 0 0 0 0 0 0 0 0 0 0 0 0 0 0 0 0 0 0 0 0 0 0 0 0 0 0 0 0 0 0 0 0 0 0 0 0 0 0 0 0 0 0 0 0 0 0 0 0 0 0 0 0 0 0 0 0 0 0 0 0 0 0 0 0 0 0 0 0 0 0 0 0 0 0 0 0 0 0 1 20 9 5 20 20 51 20 20 20 56 57 9 5 1 1 
0 0 0 0 0 0 0 0 0 0 0 0 0 0 0 0 0 0 0 0 0 0 0 0 0 0 0 0 0 0 0 0 0 0 0 0 0 0 0 0 0 0 0 0 0 0 0 0 0 0 0 0 0 0 0 0 0 0 0 0 0 0 0 0 0 0 0 0 0 0 0 0 0 0 0 0 0 0 0 0 0 0 0 0 0 0 0 0 0 0 0 0 0 0 0 0 0 0 0 0 0 0 0 0 0 0 0 0 0 0 0 0 1 1 38 39 60 49 61 55 62 63 20 20 9 5 1 1 
0 0 0 0 0 0 0 0 0 0 0 0 0 0 0 0 0 0 0 0 0 0 0 0 0 0 0 0 0 0 0 0 0 0 0 0 0 0 0 0 0 0 0 0 0 0 0 0 0 0 0 0 0 0 0 0 0 0 0 0 0 0 0 0 0 0 0 0 0 0 0 0 0 0 0 0 0 0 0 0 0 0 0 0 0 0 0 0 0 0 0 0 0 0 0 0 0 0 0 0 0 0 0 0 0 0 0 0 0 0 0 0 1 1 1 1 1 1 1 1 1 1 20 20 9 5 1 1 
0 0 0 0 0 0 0 0 0 0 0 0 0 0 0 0 0 0 0 0 0 0 0 0 0 0 0 0 0 0 0 0 0 0 0 0 0 0 0 0 0 0 0 0 0 0 0 0 0 0 0 0 0 0 0 0 0 0 0 0 0 0 0 0 0 0 0 0 0 0 0 0 0 0 0 0 0 0 0 0 0 0 0 0 0 0 0 0 0 0 0 0 0 0 0 0 0 0 0 0 0 0 0 0 0 0 0 0 0 0 0 0 1 1 4 5 66 67 20 20 20 20 20 20 38 39 1 1 
0 0 0 0 0 0 0 0 0 0 0 0 0 0 0 0 0 0 0 0 0 0 0 0 0 0 0 0 0 0 0 0 0 0 0 0 0 0 0 0 0 0 0 0 0 0 0 0 0 0 0 0 0 0 0 0 0 0 0 0 0 0 0 0 0 0 0 0 0 0 0 0 0 0 0 0 0 0 0 0 0 0 0 0 0 0 0 0 0 0 0 0 0 0 0 0 0 0 0 0 0 0 0 0 0 0 0 0 0 0 0 0 1 1 9 5 56 57 70 20 20 20 46 1 1 1 1 1 
0 0 0 0 0 0 0 0 0 0 0 0 0 0 0 0 0 0 0 0 0 0 0 0 0 0 0 0 0 0 0 0 0 0 0 0 0 0 0 0 0 0 0 0 0 0 0 0 0 0 0 0 0 0 0 0 0 0 0 0 0 0 0 0 0 0 0 0 0 0 0 0 0 0 0 0 0 0 0 0 0 0 0 0 0 0 0 0 0 0 0 0 0 0 0 0 0 0 0 0 0 0 0 0 0 0 0 0 0 0 0 0 29 30 9 5 20 20 20 20 60 49 20 20 69 30 1 1 
0 0 0 0 0 0 0 0 0 0 0 0 0 0 0 0 0 0 0 0 0 0 0 0 0 0 0 0 0 0 0 0 0 0 0 0 0 0 0 0 0 0 0 0 0 0 0 0 0 0 0 0 0 0 0 0 0 0 0 0 0 0 0 0 0 0 0 0 0 0 0 0 0 0 0 0 0 0 0 0 0 0 0 0 0 0 0 0 0 0 0 0 0 0 0 0 0 0 0 0 0 0 0 0 0 0 0 0 0 0 0 0 34 35 9 5 20 20 20 20 49 20 20 20 54 55 1 1 
0 0 0 0 0 0 0 0 0 0 0 0 0 0 0 0 0 0 0 0 0 0 0 0 0 0 0 0 0 0 0 0 0 0 0 0 0 0 0 0 0 0 0 0 0 0 0 0 0 0 0 0 0 0 0 0 0 0 0 0 0 0 0 0 0 0 0 0 0 0 0 0 0 0 0 0 0 0 0 0 0 0 0 0 0 0 0 0 0 0 0 0 0 0 0 0 0 0 0 0 0 0 0 0 0 0 0 0 0 0 0 0 40 41 38 39 54 55 60 49 62 63 62 63 54 55 1 1 
0 0 0 0 0 0 0 0 0 0 0 0 0 0 0 0 0 0 0 0 0 0 0 0 0 0 0 0 0 0 0 0 0 0 0 0 0 0 0 0 0 0 0 0 0 0 0 0 0 0 0 0 0 0 0 0 0 0 0 0 0 0 0 0 0 0 0 0 0 0 0 0 0 0 0 0 0 0 0 0 0 0 0 0 0 0 0 0 0 0 0 0 0 0 0 0 0 0 0 0 0 0 0 0 0 0 0 0 0 0 0 0 1 1 1 1 1 1 1 1 1 1 1 1 1 1 1 1 
0 0 0 0 0 0 0 0 0 0 0 0 0 0 0 0 0 0 0 0 0 0 0 0 0 0 0 0 0 0 0 0 0 0 0 0 0 0 0 0 0 0 0 0 0 0 0 0 0 0 0 0 0 0 0 0 0 0 0 0 0 0 0 0 0 0 0 0 0 0 0 0 0 0 0 0 0 0 0 0 0 0 0 0 0 0 0 0 0 0 0 0 0 0 0 0 0 0 0 0 0 0 0 0 0 0 0 0 0 0 0 0 0 0 0 0 0 0 0 0 0 0 0 0 0 0 0 0 
