0			0			2048			816			4			0			
0			0			1024			408			4			0			
0			0			512			204			4			0			
0			0			256			102			0			4			0		1		2		3		
256			0			256			102			0			4			477		478		479		480		
0			102			256			102			0			24			3		4		5		6		7		8		9		10		11		12		13		14		15		16		17		18		19		20		21		22		427		476		548		583		
256			102			256			102			0			27			23		24		25		26		27		28		29		30		31		32		33		34		35		36		37		38		39		426		428		429		430		477		478		479		480		528		529		
512			0			512			204			4			0			
512			0			256			102			0			8			58		59		60		61		481		482		483		484		
768			0			256			102			0			0			
512			102			256			102			0			29			40		41		42		43		44		45		46		47		48		49		50		51		52		53		54		55		56		57		58		431		432		433		434		481		482		483		484		581		582		
768			102			256			102			0			0			
0			204			512			204			4			0			
0			204			256			102			0			9			62		63		64		65		66		168		169		534		543		
256			204			256			102			0			18			152		153		154		155		156		157		158		159		160		161		162		163		164		165		166		167		535		588		
0			306			256			102			0			33			66		67		68		69		70		71		72		73		74		75		76		77		78		79		80		81		82		83		84		168		169		170		171		172		435		436		485		486		487		549		553		576		577		
256			306			256			102			0			28			85		86		87		88		89		90		91		92		93		94		95		96		97		98		99		100		101		102		437		438		439		440		488		489		490		491		492		587		
512			204			512			204			4			0			
512			204			256			102			0			21			137		138		139		140		141		142		143		144		145		146		147		148		149		150		151		173		174		578		579		580		581		
768			204			256			102			0			19			133		134		135		136		175		176		177		178		179		180		181		182		183		184		185		186		444		497		584		
512			306			256			102			0			32			103		104		105		106		107		108		109		110		111		112		113		114		115		116		117		118		121		122		123		124		125		126		127		128		441		442		443		493		494		495		550		554		
768			306			256			102			0			35			119		120		129		130		131		132		175		176		177		178		179		180		181		182		183		184		185		186		240		241		242		243		244		245		246		247		248		453		454		496		498		530		574		575		584		
1024			0			1024			408			4			0			
1024			0			512			204			0			0			
1536			0			512			204			0			0			
1024			204			512			204			4			0			
1024			204			256			102			0			10			187		188		189		190		445		446		499		501		589		590		
1280			204			256			102			0			26			191		192		193		194		195		196		197		198		199		200		201		202		203		204		205		206		447		448		449		503		504		505		541		542		551		555		
1024			306			256			102			0			26			187		188		189		190		227		228		229		230		231		232		233		234		235		236		237		238		239		451		452		500		502		531		532		540		589		590		
1280			306			256			102			0			33			191		192		193		194		196		197		198		199		200		201		202		207		208		209		210		211		212		213		214		215		216		217		218		219		220		221		222		223		224		225		226		450		506		
1536			204			512			204			0			0			
0			408			1024			408			4			0			
0			408			512			204			4			0			
0			408			256			102			0			0			
256			408			256			102			0			1			102		
0			510			256			102			0			0			
256			510			256			102			0			0			
512			408			512			204			4			0			
512			408			256			102			0			16			103		104		105		106		107		108		109		110		111		112		113		114		115		116		117		118		
768			408			256			102			0			33			119		120		249		250		251		252		253		254		255		256		257		264		265		266		267		268		269		270		271		272		273		274		275		455		456		457		507		508		509		539		572		573		574		
512			510			256			102			0			0			
768			510			256			102			0			21			255		256		257		258		259		260		261		262		263		264		265		266		267		268		269		270		271		272		273		274		275		
0			612			512			204			0			0			
512			612			512			204			0			0			
1024			408			1024			408			4			0			
1024			408			512			204			4			0			
1024			408			256			102			0			25			276		277		278		279		280		281		282		283		284		285		286		287		288		289		290		291		458		459		460		461		510		511		512		513		547		
1280			408			256			102			0			25			292		293		294		295		296		297		298		299		300		301		302		303		304		305		306		307		462		463		464		465		514		515		516		517		533		
1024			510			256			102			0			14			276		277		280		281		282		283		284		285		286		287		288		289		290		291		
1280			510			256			102			0			16			292		293		294		295		296		297		298		299		300		301		302		303		304		305		306		307		
1536			408			512			204			4			0			
1536			408			256			102			0			19			308		309		310		317		318		321		322		335		336		337		338		466		467		468		518		519		520		538		585		
1792			408			256			102			0			23			339		340		357		358		359		360		361		362		363		364		365		366		469		470		471		472		521		522		523		524		544		552		556		
1536			510			256			102			0			36			308		309		311		312		313		314		315		316		317		318		319		320		321		322		323		324		325		326		327		328		329		330		331		332		333		334		335		336		337		338		342		343		344		345		346		347		
1792			510			256			102			0			43			339		340		341		348		349		350		351		352		353		354		355		356		357		358		359		360		361		366		367		368		369		370		371		372		373		374		375		376		377		378		379		380		381		382		412		537		552		556		567		568		569		570		571		
1024			612			512			204			0			0			
1536			612			512			204			4			0			
1536			612			256			102			0			0			
1792			612			256			102			0			32			383		384		385		386		407		408		409		410		411		412		413		414		415		416		418		419		420		421		422		423		424		425		474		526		536		545		557		558		563		564		565		566		
1536			714			256			102			0			0			
1792			714			256			102			0			34			387		388		389		390		391		392		393		394		395		396		397		398		399		400		401		402		403		404		405		406		407		416		417		473		475		525		527		546		558		559		560		561		562		586		
